# Gboard Dictionary version:1
あーる	R	ja-JP
あいう゛い	アイヴイ	ja-JP
あいすこーひー	アイスコーヒー	ja-JP
あいてむ	Pアイテム	ja-JP
あいどるか	アイドル科	ja-JP
あさいちのたすけぶね	朝一の助け舟	ja-JP
あさり	亜紗里	ja-JP
あさりせんせい	亜紗里先生	ja-JP
あそびのーと	ASOBINOTES	ja-JP
あどりぶ	アドリブ	ja-JP
あふれるおもいで	あふれる思い出	ja-JP
ありがとうのことば	ありがとうの言葉	ja-JP
ありむらまお	有村麻央	ja-JP
いっしょにおひるねぽぷり	一緒にお昼寝ポプリ	ja-JP
いっぴきおおかみ	一匹狼	ja-JP
いいだひかる	飯田ヒカル	ja-JP
いしきのきほん	意識の基本	ja-JP
いちねんいちくみ	1年1組	ja-JP
いちねんいちくみの	1年1組のアイドルたち	ja-JP
いちねんさんくみ	1年3組	ja-JP
いちねんにくみ	1年2組	ja-JP
いちばんむいてないこと	一番向いてないこと	ja-JP
いつものめいくぽーち	いつものメイクポーチ	ja-JP
いとうまお	伊藤舞音	ja-JP
いめとれ	イメトレ	ja-JP
うーろんちゃ	烏龍茶	ja-JP
うすいゆり	薄井友里	ja-JP
うちなるひかりのみみかざり	内なる光の耳飾り	ja-JP
うめ	佑芽	ja-JP
えーぴーどりん	APドリンク	ja-JP
えいえいおー	えいえいおー	ja-JP
えすあーる	SR	ja-JP
えすえすあーる	SSR	ja-JP
えすえすれあ	SSR	ja-JP
えすぴーれっすん	SPレッスン	ja-JP
えすれあ	SR	ja-JP
えたいのしれないもの	得体のしれないモノ	ja-JP
おきにのすにーかー	お気にのスニーカー	ja-JP
おじかなお	小鹿なお	ja-JP
おねえさまだいひゃっか	お姉さま大百科	ja-JP
おもいだしわらい	思い出し笑い	ja-JP
おもいでろぼ	思い出ロボ	ja-JP
かいか	開花	ja-JP
かつらぎりーりや	葛城リーリヤ	ja-JP
かやりんは	賀陽燐羽	ja-JP
かわいいしぐさ	可愛い仕草	ja-JP
かわいいはじめました	カワイイ♡はじめました	ja-JP
かわむられいな	川村玲奈	ja-JP
がいぶせい	外部生	ja-JP
がくえんあいどるますたー	学園アイドルマスター	ja-JP
がくえんせいかつ	学園生活	ja-JP
がくます	学マス	ja-JP
がしゃ	ガシャ	ja-JP
きゃんぱすもーど	Campus mode!!	ja-JP
きょうもおはよう	今日もおはよう	ja-JP
きぶんてんかん	気分転換	ja-JP
きみへのさしいれ	きみへの差し入れ	ja-JP
きらめき	キラメキ	ja-JP
くおりあーつ	QualiArts	ja-JP
くにお	邦夫	ja-JP
くもりをぬぐったたおる	曇りをぬぐったタオル	ja-JP
くやしさのしょうちょう	悔しさの象徴	ja-JP
くらむじーとりっく	clumsy trick	ja-JP
くらもとちな	倉本千奈	ja-JP
げーせんのせんりひん	ゲーセンの戦利品	ja-JP
げんきなあいさつ	元気な挨拶	ja-JP
げんせんはつぼしまきあーと	厳選初星マキアート	ja-JP
こーるあんどれすぽんす	コール&レスポンス	ja-JP
こいんがしゃ	コインガシャ	ja-JP
こうけい	光景	ja-JP
こくみんてきあいどる	国民的アイドル	ja-JP
ことね	ことね	ja-JP
こみゅ	コミュ	ja-JP
さーくる	サークル	ja-JP
さいちょうせんちけ	再挑戦チケット	ja-JP
さき	咲季	ja-JP
さきのかんぜんしょくれしぴ	咲季の完全食レシピ	ja-JP
さぽーとかーど	サポートカード	ja-JP
さんねんいちく	3年1組	ja-JP
しょげないはんかち	しょげないハンカチ	ja-JP
しあわせなじかん	幸せな時間	ja-JP
しうんすみか	紫雲清夏	ja-JP
しずかないし	静かな意志	ja-JP
しのさわひろ	篠澤広	ja-JP
しんあいど	親愛度	ja-JP
しんぐあっぷ	SyngUp!	ja-JP
しんしふうはんかちーふ	紳士風ハンカチーフ	ja-JP
しんらいのあかし	信頼の証	ja-JP
じゅうおうくにお	十王邦夫	ja-JP
じゅうおうせな	十王星南	ja-JP
じゅうおうぷろ	十王プロ	ja-JP
じゅうおうぷろ	100プロ	ja-JP
じゅうれんがしゃ	10連ガシャ	ja-JP
じゅえる	ジュエル	ja-JP
じぶんをまもるいやほん	自分を守るイヤホン	ja-JP
すかうとさえぎりぼう	スカウト遮り帽	ja-JP
すきるかーど	スキルカード	ja-JP
すたみなばくはつどりんく	スタミナ爆発ドリンク	ja-JP
すとーりーいべ	ストーリーイベントPt	ja-JP
すぺしゃるれっすん	SPレッスン	ja-JP
すみか	清夏	ja-JP
せかいいちかわいいわたし	世界一可愛い私	ja-JP
せな	星南	ja-JP
せんす	センス	ja-JP
せんすがしゃ	センスガシャ	ja-JP
せんすこいん	センスコイン	ja-JP
そんざいかん	存在感	ja-JP
ためらいわんすてっぷ	Tame-Lie-One-Step	ja-JP
だとうこんでんえいねん	打倒！墾田永年私財法	ja-JP
だめだめくっきんぐ	ダメダメクッキング	ja-JP
だれでもわかるにゅうもんしょ	だれでもわかる入門書	ja-JP
だん	Da	ja-JP
だんす	Da	ja-JP
ちょうぜつあんみんますく	超絶あんみんマスク	ja-JP
ちかいのはなびら	誓いの花びら	ja-JP
ちけっとがしゃ	チケットガシャ	ja-JP
ちな	千奈	ja-JP
ちびどもてづくりめだる	ちびども手作りメダル	ja-JP
つきむらてまり	月村手毬	ja-JP
てがきのめっせーじ	手書きのメッセージ	ja-JP
てづくりのごほうび	手作りのご褒美	ja-JP
てびょうし	手拍子	ja-JP
てまり	手毬	ja-JP
てんしんらんまん	天真爛漫	ja-JP
でぃありとるぷりんす	Dearリトルプリンス	ja-JP
でいりーこうかんじょ	デイリー交換所	ja-JP
とぅるーえんど	True End	ja-JP
とうしんだいのれでぃりっぷ	等身大のレディリップ	ja-JP
ときめき	トキメキ	ja-JP
とくたいせい	特待生	ja-JP
とどいて	届いて！	ja-JP
ともにたたかうたおる	共に戦うタオル	ja-JP
とれーなー	トレーナー	ja-JP
どりんく	APドリンク	ja-JP
どりんく	初星ホエイプロテイン	ja-JP
どりんく	厳選初星マキアート	ja-JP
どりんく	初星ブーストエナジー	ja-JP
どりんく	スタミナ爆発ドリンク	ja-JP
どりんく	ビタミンドリンク	ja-JP
どりんく	初星スペシャル青汁	ja-JP
どりんく	リカバリドリンク	ja-JP
どりんく	ミックススムージー	ja-JP
どりんく	フレッシュビネガー	ja-JP
どりんく	烏龍茶	ja-JP
どりんく	アイスコーヒー	ja-JP
どりんく	Pドリンク	ja-JP
ないぶせい	内部生	ja-JP
なかなおりのきっかけ	仲直りのきっかけ	ja-JP
ながつきあおい	長月あおい	ja-JP
ななせつむぎ	七瀬つむぎ	ja-JP
なりやまないはくしゅ	鳴り止まない拍手	ja-JP
にゅうがくしけん	入学試験首席	ja-JP
にじいろどりーまー	虹色ドリーマー	ja-JP
にひゃくぱーせんとすまいる	200%スマイル	ja-JP
ねおあさり	根緒亜紗里	ja-JP
ねがいをかなえるおまもり	願いを叶えるお守り	ja-JP
のーとのはじのけつい	ノートの端の決意	ja-JP
はーとのあいず	ハートの合図	ja-JP
はくせん	白線	ja-JP
はげまし	励まし	ja-JP
はじまりはかっこよく	はじまりはカッコよく	ja-JP
はじめ	初	ja-JP
はたやみすず	秦谷美鈴	ja-JP
はつぼし	初星	ja-JP
はつぼしががくえんひこう	初星学園非公認マスコットはつみちゃん	ja-JP
はつぼしががくえんひこう	初星学園非公認マスコット	ja-JP
はつぼしがくえん	初星学園	ja-JP
はつぼしがくえんお	初星学園音楽部	ja-JP
はつぼしきーほるだー	はつぼしキーホルダー	ja-JP
はつぼしすぺしゃるあおじる	初星スペシャル青汁	ja-JP
はつぼしてぃーしゃつ	はつぼしTシャツ	ja-JP
はつぼしてちょう	はつぼし手帳	ja-JP
はつぼしぶーすとえなじー	初星ブーストエナジー	ja-JP
はつぼしぶれすれっと	はつぼしブレスレット	ja-JP
はつぼしぶろーち	はつぼしブローチ	ja-JP
はつぼしほえいぷろていん	初星ホエイプロテイン	ja-JP
はつみちゃん	はつみちゃん	ja-JP
はつみちゃんのきら	はつみちゃんのキラっと☆プロデュース教室	ja-JP
はないわかな	花岩香奈	ja-JP
はなみうめ	花海佑芽	ja-JP
はなみさき	花海咲季	ja-JP
はるさきのん	春咲暖	ja-JP
ばくおんらいおん	ばくおんライオン	ja-JP
ばずわーど	バズワード	ja-JP
ぱすてるきぶん	パステル気分	ja-JP
ぱらめーた	パラメータ	ja-JP
ひっすすてんれすぼとる	必携ステンレスボトル	ja-JP
ひたかましろ	陽高真白	ja-JP
ひとつふみだしたさきに	一つ踏み出した先に	ja-JP
ひなたぼっこ	ひなたぼっこ	ja-JP
ひみつとっくんかーで	ひみつ特訓カーデ	ja-JP
ひめさきりなみ	姫崎莉波	ja-JP
ひろ	広	ja-JP
びー	Vi	ja-JP
びじゅある	Vi	ja-JP
びたみんどりんく	ビタミンドリンク	ja-JP
ぴっぐどりーむ	ピッグドリーム貯金箱	ja-JP
ぴーあいてむ	Pアイテム	ja-JP
ぴーどりんく	Pドリンク	ja-JP
ぴーぽいんと	Pポイント	ja-JP
ぴんくのおそろいどりんく	ピンクのお揃いブレス	ja-JP
ふぁいてぃんぐまいうぇい	Fighting My Way	ja-JP
ふぁんしーちゃーむ	ファンシーチャーム	ja-JP
ふじたことね	藤田ことね	ja-JP
ふれっしゅびねがー	フレッシュビネガー	ja-JP
ふれあい	ふれあい	ja-JP
ふれんどこいん	フレンドコイン	ja-JP
ふろーらいと	Fluorite	ja-JP
ふわっとぶれざー	ふわっとブレザーつむじちゃん	ja-JP
ふわふわでもこもこ	ふわふわでもこもこ	ja-JP
ぷりますてら	プリマステラ	ja-JP
ぷろでゅーさー	プロデューサー	ja-JP
ぷろでゅーさーか	プロデューサー科	ja-JP
ぷろでゅーす	プロデュース	ja-JP
ぷろでゅーすかーど	プロデュースカード	ja-JP
べてらんのーと	ベテランノート	ja-JP
ほうかごのらくがき	放課後のらくがき	ja-JP
ほしくずせんせーしょん	星屑センセーション	ja-JP
ほしのりとるぷりんす	星のリトルプリンス	ja-JP
ほんばんぜんや	本番前夜	ja-JP
ぼー	Vo	ja-JP
ぼーかる	Vo	ja-JP
ぽいんと	Pポイント	ja-JP
まお	麻央	ja-JP
ますこっと	マスコット(非公認)	ja-JP
ますたーのーと	マスターノート	ja-JP
まつだあやね	松田彩音	ja-JP
まにー	マニー	ja-JP
まんかいぺあへあぴん	満開ペアヘアピン	ja-JP
みっくすすむーじー	ミックススムージー	ja-JP
みすず	美鈴	ja-JP
みすずからのおくりもの	美鈴からの贈り物	ja-JP
みちくさけんきゅうのーと	みちくさ研究ノート	ja-JP
みどりのおそろいぶれす	緑のお揃いブレス	ja-JP
みなとみや	湊みや	ja-JP
みわくのしせん	魅惑の視線	ja-JP
みわくのぱふぉーまんす	魅惑のパフォーマンス	ja-JP
みんなだいすき	みんな大好き	ja-JP
むねをはっていっぽずつ	胸を張って一歩ずつ	ja-JP
めせんのきほん	目線の基本	ja-JP
もうすこしだけ	もう少しだけ	ja-JP
やるきはまんてん	やる気は満点	ja-JP
ゆめにあふれたおおにもつ	夢にあふれた大荷物	ja-JP
ゆめへのらいふろぐ	夢へのライフログ	ja-JP
ゆめへのりすたーと	夢へのリスタート	ja-JP
ゆめみごこち	ゆめみごこち	ja-JP
ゆるふわおしゃべり	ゆるふわおしゃべり	ja-JP
らぶりーういんく	ラブリーウインク	ja-JP
りーぴゃん	りーぴゃん	ja-JP
りーりや	リーリヤ	ja-JP
りかばりどりんく	リカバリドリンク	ja-JP
りくえすと	リクエスト	ja-JP
りすたーと	リスタート	ja-JP
りずみかる	リズミカル	ja-JP
りとるぷりんす	リトルプリンス	ja-JP
りなみ	莉波	ja-JP
りなみおねえちゃん	莉波お姉ちゃん	ja-JP
るなせいめいびー	Luna say maybe	ja-JP
れっすんのーと	レッスンノート	ja-JP
れあ	R	ja-JP
れいのえすえすでぃーのひみつ	例のSSDの秘密	ja-JP
ろじっく	ロジック	ja-JP
ろじっくがしゃ	ロジックガシャ	ja-JP
ろじっくこいん	ロジックコイン	ja-JP
わくわくがとまらない	ワクワクが止まらない	ja-JP
わたしがいちばん	わたしが一番！	ja-JP
わたしがすたー	私がスター	ja-JP
わたしがみつけたいつざいめも	私が見つけた逸材メモ	ja-JP
わたしのはじめのがくふ	私の「初」の楽譜	ja-JP
わたしらしさのはじまり	『私らしさ』のはじまり	ja-JP
わんだーすけーる	Wonder Scale	ja-JP
