!!ATOK_TANGO_TEXT_HEADER_1
!!一覧出力
!!単語種類;登録単語(*)
!!出力日時;24/06/12 03:50

あーる	R	名詞*
あいう゛い	アイヴイ	名詞*
あいすこーひー	アイスコーヒー	名詞*
あいてむ	Pアイテム	名詞*
あいどるか	アイドル科	名詞*
あいどるはじめ	アイドル、はじめっ!	名詞*
あさいちのたすけぶね	朝一の助け舟	名詞*
あさり	亜紗里	名詞*
あさりせんせい	亜紗里先生	名詞*
あそびのーと	ASOBINOTES	名詞*
あどりぶ	アドリブ	名詞*
あどれなりん	アドレナリン全開	名詞*
あふれるおもいで	あふれる思い出	名詞*
ありがとうのことば	ありがとうの言葉	名詞*
ありむらまお	有村麻央	名詞*
いっしょにおひるねぽぷり	一緒にお昼寝ポプリ	名詞*
いっぴきおおかみ	一匹狼	名詞*
いいだひかる	飯田ヒカル	名詞*
いえろーびっぐ	Yellow Big Bang!	名詞*
いしきのきほん	意識の基本	名詞*
いちねんいちくみ	1年1組	名詞*
いちねんいちくみの	1年1組のアイドルたち	名詞*
いちねんさんくみ	1年3組	名詞*
いちねんにくみ	1年2組	名詞*
いちばんむいてないこと	一番向いてないこと	名詞*
いつものめいくぽーち	いつものメイクポーチ	名詞*
いとうまお	伊藤舞音	名詞*
いべんとこうかん	イベント交換所	名詞*
いめとれ	イメトレ	名詞*
うーろんちゃ	烏龍茶	名詞*
うすいゆり	薄井友里	名詞*
うちなるひかりのみみかざり	内なる光の耳飾り	名詞*
うめ	佑芽	名詞*
えーぴーどりん	APドリンク	名詞*
えいえいおー	えいえいおー	名詞*
えすあーる	SR	名詞*
えすえすあーる	SSR	名詞*
えすえすれあ	SSR	名詞*
えすぴーれっすん	SPレッスン	名詞*
えすれあ	SR	名詞*
えたいのしれないもの	得体のしれないモノ	名詞*
おっきなおにぎり	おっきなおにぎり	名詞*
おきにのすにーかー	お気にのスニーカー	名詞*
おじかなお	小鹿なお	名詞*
おねえさまだいひゃっか	お姉さま大百科	名詞*
おもいだしわらい	思い出し笑い	名詞*
おもいでろぼ	思い出ロボ	名詞*
かいか	開花	名詞*
かつらぎりーりや	葛城リーリヤ	名詞*
かなえたいこと	叶えたい、ことは゛かり	名詞*
かやりんは	賀陽燐羽	名詞*
かわいいしぐさ	可愛い仕草	名詞*
かわいいはじめました	カワイイはじめました	名詞*
かわむられいな	川村玲奈	名詞*
がいぶせい	外部生	名詞*
がくえんあいどるますたー	学園アイドルマスター	名詞*
がくえんせいかつ	学園生活	名詞*
がくます	学マス	名詞*
がしゃ	ガシャ	名詞*
きゃんぱすもーど	Campus mode!!	名詞*
きょうもおはよう	今日もおはよう	名詞*
きぶんてんかん	気分転換	名詞*
きみへのさしいれ	きみへの差し入れ	名詞*
きらめき	キラメキ	名詞*
くおりあーつ	QualiArts	名詞*
くにお	邦夫	名詞*
くもりをぬぐったたおる	曇りをぬぐったタオル	名詞*
くやしさのしょうちょう	悔しさの象徴	名詞*
くらむじーとりっく	clumsy trick	名詞*
くらもとちな	倉本千奈	名詞*
げーせんのせんりひん	ゲーセンの戦利品	名詞*
げんきなあいさつ	元気な挨拶	名詞*
げんせんはつぼしまきあーと	厳選初星マキアート	名詞*
こーるあんどれすぽんす	コール&レスポンス	名詞*
こいんがしゃ	コインガシャ	名詞*
こうけい	光景	名詞*
こくみんてきあいどる	国民的アイドル	名詞*
ことね	ことね	名詞*
こみゅ	コミュ	名詞*
さーくる	サークル	名詞*
さいこうにはっぴー	最高にハッピーの源	名詞*
さいちょうせんちけ	再挑戦チケット	名詞*
さき	咲季	名詞*
さきのかんぜんしょくれしぴ	咲季の完全食レシピ	名詞*
さぽーとかーど	サポートカード	名詞*
さぽーとのあかし	サポートの証	名詞*
さんねんいちく	3年1組	名詞*
ざろーりんぐらいす	The Rolling Riceball	名詞*
しょげないはんかち	しょげないハンカチ	名詞*
しあわせなじかん	幸せな時間	名詞*
しうんすみか	紫雲清夏	名詞*
しずかないし	静かな意志	名詞*
しのさわひろ	篠澤広	名詞*
しんあいど	親愛度	名詞*
しんぐあっぷ	SyngUp!	名詞*
しんしふうはんかちーふ	紳士風ハンカチーフ	名詞*
しんらいのあかし	信頼の証	名詞*
じゅうおうくにお	十王邦夫	名詞*
じゅうおうせな	十王星南	名詞*
じゅうおうぷろ	十王プロ	名詞*
じゅうおうぷろ	100プロ	名詞*
じゅうれんがしゃ	10連ガシャ	名詞*
じゅえる	ジュエル	名詞*
じぶんをまもるいやほん	自分を守るイヤホン	名詞*
すかうとさえぎりぼう	スカウト遮り帽	名詞*
すきるかーど	スキルカード	名詞*
すたみなばくはつどりんく	スタミナ爆発ドリンク	名詞*
すとーりーいべ	ストーリーイベントPt	名詞*
すぺしゃるれっすん	SPレッスン	名詞*
すみか	清夏	名詞*
せかいいちかわいいわたし	世界一可愛い私	名詞*
せな	星南	名詞*
せんす	センス	名詞*
せんすがしゃ	センスガシャ	名詞*
せんすこいん	センスコイン	名詞*
そんざいかん	存在感	名詞*
ためらいわんすてっぷ	Tame-Lie-One-Step	名詞*
だとうこんでんえいねん	打倒！墾田永年私財法	名詞*
だめだめくっきんぐ	ダメダメクッキング	名詞*
だれでもわかるにゅうもんしょ	だれでもわかる入門書	名詞*
だん	Da	名詞*
だんす	Da	名詞*
ちょうぜつあんみんますく	超絶あんみんマスク	名詞*
ちかいのはなびら	誓いの花びら	名詞*
ちけっとがしゃ	チケットガシャ	名詞*
ちな	千奈	名詞*
ちびどもてづくりめだる	ちびども手作りメダル	名詞*
つきむらてまり	月村手毬	名詞*
てがきのめっせーじ	手書きのメッセージ	名詞*
てづくりのごほうび	手作りのご褒美	名詞*
てびょうし	手拍子	名詞*
てまり	手毬	名詞*
てまりん	てまりん	名詞*
てんしんらんまん	天真爛漫	名詞*
でぃありとるぷりんす	Dearリトルプリンス	名詞*
でいりーこうかんじょ	デイリー交換所	名詞*
とぅるーえんど	True End	名詞*
とうしんだいのれでぃりっぷ	等身大のレディリップ	名詞*
ときめき	トキメキ	名詞*
とくたいせい	特待生	名詞*
とどいて	届いて！	名詞*
ともにたたかうたおる	共に戦うタオル	名詞*
とれーなー	トレーナー	名詞*
どりんく	APドリンク	名詞*
どりんく	初星ホエイプロテイン	名詞*
どりんく	厳選初星マキアート	名詞*
どりんく	初星ブーストエナジー	名詞*
どりんく	スタミナ爆発ドリンク	名詞*
どりんく	ビタミンドリンク	名詞*
どりんく	初星スペシャル青汁	名詞*
どりんく	リカバリドリンク	名詞*
どりんく	ミックススムージー	名詞*
どりんく	フレッシュビネガー	名詞*
どりんく	烏龍茶	名詞*
どりんく	アイスコーヒー	名詞*
どりんく	Pドリンク	名詞*
ないぶせい	内部生	名詞*
なかなおりのきっかけ	仲直りのきっかけ	名詞*
ながつきあおい	長月あおい	名詞*
ななせつむぎ	七瀬つむぎ	名詞*
なりやまないはくしゅ	鳴り止まない拍手	名詞*
にゅうがくしけん	入学試験首席	名詞*
にじいろどりーまー	虹色ドリーマー	名詞*
にひゃくぱーせんとすまいる	200%スマイル	名詞*
ねおあさり	根緒亜紗里	名詞*
ねがいをかなえるおまもり	願いを叶えるお守り	名詞*
のーとのはじのけつい	ノートの端の決意	名詞*
はーとのあいず	ハートの合図	名詞*
はくせん	白線	名詞*
はげまし	励まし	名詞*
はじまりはかっこよく	はじまりはカッコよく	名詞*
はじめ	初	名詞*
はたやみすず	秦谷美鈴	名詞*
はつぼし	初星	名詞*
はつぼしががくえんひこう	初星学園非公認マスコットはつみちゃん	名詞*
はつぼしががくえんひこう	初星学園非公認マスコット	名詞*
はつぼしがくえん	初星学園	名詞*
はつぼしがくえんお	初星学園音楽部	名詞*
はつぼしきーほるだー	はつぼしキーホルダー	名詞*
はつぼしすぺしゃるあおじる	初星スペシャル青汁	名詞*
はつぼしてぃーしゃつ	はつぼしTシャツ	名詞*
はつぼしてちょう	はつぼし手帳	名詞*
はつぼしぶーすとえなじー	初星ブーストエナジー	名詞*
はつぼしぶれすれっと	はつぼしブレスレット	名詞*
はつぼしぶろーち	はつぼしブローチ	名詞*
はつぼしほえいぷろていん	初星ホエイプロテイン	名詞*
はつみちゃん	はつみちゃん	名詞*
はつみちゃんのきら	はつみちゃんのキラっと☆プロデュース教室	名詞*
はないわかな	花岩香奈	名詞*
はなみうめ	花海佑芽	名詞*
はなみさき	花海咲季	名詞*
はるさきのん	春咲暖	名詞*
ばくおんらいおん	ばくおんライオン	名詞*
ばずわーど	バズワード	名詞*
ぱすてるきぶん	パステル気分	名詞*
ぱらめーた	パラメータ	名詞*
ひっすすてんれすぼとる	必携ステンレスボトル	名詞*
ひたかましろ	陽高真白	名詞*
ひとつふみだしたさきに	一つ踏み出した先に	名詞*
ひなたぼっこ	ひなたぼっこ	名詞*
ひみつとっくんかーで	ひみつ特訓カーデ	名詞*
ひめさきりなみ	姫崎莉波	名詞*
ひろ	広	名詞*
びー	Vi	名詞*
びじゅある	Vi	名詞*
びたみんどりんく	ビタミンドリンク	名詞*
ぴっぐどりーむ	ピッグドリーム貯金箱	名詞*
ぴーあいてむ	Pアイテム	名詞*
ぴーどりんく	Pドリンク	名詞*
ぴーぽいんと	Pポイント	名詞*
ぴんくのおそろいどりんく	ピンクのお揃いブレス	名詞*
ふぁいてぃんぐまいうぇい	Fighting My Way	名詞*
ふぁんしーちゃーむ	ファンシーチャーム	名詞*
ふじたことね	藤田ことね	名詞*
ふらわー	フラワー	名詞*
ふれっしゅびねがー	フレッシュビネガー	名詞*
ふれあい	ふれあい	名詞*
ふれんどこいん	フレンドコイン	名詞*
ふろーらいと	Fluorite	名詞*
ふわっとぶれざー	ふわっとブレザーつむじちゃん	名詞*
ふわふわでもこもこ	ふわふわでもこもこ	名詞*
ぷりますてら	プリマステラ	名詞*
ぷろでゅーさー	プロデューサー	名詞*
ぷろでゅーさーか	プロデューサー科	名詞*
ぷろでゅーす	プロデュース	名詞*
ぷろでゅーすかーど	プロデュースカード	名詞*
べてらんのーと	ベテランノート	名詞*
ほうかごのらくがき	放課後のらくがき	名詞*
ほしくずせんせーしょん	星屑センセーション	名詞*
ほしのりとるぷりんす	星のリトルプリンス	名詞*
ほんばんぜんや	本番前夜	名詞*
ぼー	Vo	名詞*
ぼーかる	Vo	名詞*
ぽいんと	Pポイント	名詞*
まお	麻央	名詞*
ますこっと	マスコット(非公認)	名詞*
ますたーのーと	マスターノート	名詞*
まつだあやね	松田彩音	名詞*
まにー	マニー	名詞*
まりち	まりちゃん	名詞*
まんかいぺあへあぴん	満開ペアヘアピン	名詞*
みっくすすむーじー	ミックススムージー	名詞*
みすず	美鈴	名詞*
みすずからのおくりもの	美鈴からの贈り物	名詞*
みちくさけんきゅうのーと	みちくさ研究ノート	名詞*
みどりのおそろいぶれす	緑のお揃いブレス	名詞*
みなとみや	湊みや	名詞*
みわくのしせん	魅惑の視線	名詞*
みわくのぱふぉーまんす	魅惑のパフォーマンス	名詞*
みんなだいすき	みんな大好き	名詞*
むねをはっていっぽずつ	胸を張って一歩ずつ	名詞*
めせんのきほん	目線の基本	名詞*
もうすこしだけ	もう少しだけ	名詞*
やるきはまんてん	やる気は満点	名詞*
ゆめにあふれたおおにもつ	夢にあふれた大荷物	名詞*
ゆめへのらいふろぐ	夢へのライフログ	名詞*
ゆめへのりすたーと	夢へのリスタート	名詞*
ゆめみごこち	ゆめみごこち	名詞*
ゆるふわおしゃべり	ゆるふわおしゃべり	名詞*
らぶりーういんく	ラブリーウインク	名詞*
りーぴゃん	りーぴゃん	名詞*
りーりや	リーリヤ	名詞*
りかばりどりんく	リカバリドリンク	名詞*
りくえすと	リクエスト	名詞*
りすたーと	リスタート	名詞*
りずみかる	リズミカル	名詞*
りとるぷりんす	リトルプリンス	名詞*
りなみ	莉波	名詞*
りなみおねえちゃん	莉波お姉ちゃん	名詞*
るなせいめいびー	Luna say maybe	名詞*
れっすんのーと	レッスンノート	名詞*
れあ	R	名詞*
れいのえすえすでぃーのひみつ	例のSSDの秘密	名詞*
ろーりんぐらいす	The Rolling Riceball	名詞*
ろじっく	ロジック	名詞*
ろじっくがしゃ	ロジックガシャ	名詞*
ろじっくこいん	ロジックコイン	名詞*
わくわくがとまらない	ワクワクが止まらない	名詞*
わたしがいちばん	わたしが一番！	名詞*
わたしがすたー	私がスター	名詞*
わたしがみつけたいつざいめも	私が見つけた逸材メモ	名詞*
わたしのはじめのがくふ	私の「初」の楽譜	名詞*
わたしらしさのはじまり	『私らしさ』のはじまり	名詞*
わんだーすけーる	Wonder Scale	名詞*